111111111111111111111
111111111110001111111
11111111111CEP1111110
111111111111111111111
111111111111111111111
