1111111111111111111
1E110111111110000C1
100111111000C000011
110000000X000000001
1000111100000001111
1111111111111101001
1P00000011111000001
1000110001110000X01
100000X000000000001
1111111111111111111
