11111111111111111111111111111111
110E0100000C00000000000C00000001
111111111110011100000C000000C001
10C00000000000000111111111111111
100000000011110000000C0000000001
1000C000000000000P0000000C000011
11111111111111111111111111111111
