111111111111111111111
10PCC00000000000000C1
111111111110011100001
11000C000000000001111
100000000011110000001
10000C000000E00C00001
100000001100000011001
1C00000011C0110011001
100000001111001111001
111111111111111111111
