111111111111111111111111111111
1EPCC0000000000000000000000001
111111111110011100000000000001
110000000000000001111111111111
100000000011110000000000000001
100000000000000000000000000001
100000001100000011000000000001
100000001100110011000000000001
100000001111001111000000000001
100000001100000011000000000001
100000001111111111000000000001
100000000000000000000000000001
111111111111111111111111111111
