11111111111111111111111111
10PCC00000000000000C000001
1111111111100111000000C001
11000C00000000000111111111
10000000001111000000000001
10000C000000E000000000C001
10000000110000001100000001
1C000000110011001100000001
10000000111100111100000001
10000000110000001100000001
10C0000011111111110C000001
10000000000000000000000001
11111111111111111111111111
